11111111111111111111111111111
1C0000000000000C00000C0000001
10010010011110011110011110001
10010010010010000010010000001
1P01001001C010C111100111100C1
1001001001C01C00001000E0100C1
1001111001C010C111100111100C1
100000000C00C00000000000000C1
11111111111111111111111111111